# Map file for tile-based game 
# (Lines that start with '#' are comments)
# The tiles are:
#   (Space) Empty tile
#   A..Z    Tiles A through Z
#   o       Star
#   !       Music Note
#   *       Goal
#   1       Bad Guy 1 (grub)
#   2       Bad Guy 2 (fly)
AD                                                                                                         R
AD                                                                                                         R
AD                                                                                                         R
AD                          IIIIIII                     IIIIIIIIIIIIIII  IIIIIIIIIIIIIIIII                 R
AD                                                                       TUUUUUUUUS        Q               R
AD                                                                        RUUUUUUUS          Q             R
AD      ONNNNNNNNNNP    III         Q  Q  Q  Q  Q  Q  Q                   RUUUUUUUS            Q           R
AD                                                           IIII         RUUUUUUUS                        R
AD                                                                      * RUUUUUUUS                        R
AHBBBBBBBBBBBBBBBBBBBBBBBBBBBBBBBF                     EBBBBBBBBBBBBBBBBBBVUUUUUUUWNNNNNNNNNNNNNNNNNNNNNNNNV